NO textures/wall_1.xpm
SO textures/wall_2.xpm
WE textures/wall_3.xpm
EA textures/wall.xpm

F          184,113,39
C      51,198,227


111111111111111111111111111111111111111111111111
100000000000000000000000000000000000000000010001
100000000000000000000000000000000000000000000001
100000000000000000000000000000000000000000000001
100000000000000000000000000000000000000000000001
100000000000000000001111000000000000000000000001
100000000000001111110000000000000000000000000001
100000000000000000000000000000000000000000000001
100000000000000000000N00000000000000000000000111
100000000000000000000000000000000000000000001111
100000000000000000000000000000000000000000000001
100000000000000111111111111111000000000000000001
100000000000000000000000000000000000000000000001
100000000000000000000000000000000000000000000001
100000000000000000000000000000000000000000000001
100000000000000000000000000000000000000000000001
100000000000000000000000000000000000000000000001
100000000000000000000000000000000000000000000001
100000000000000000000000000000000000000000000001
100000000000000000000000000000000000000000000001
100000000000000000000000000000000000000000000001
100000000000000000000000000000000000000000000001
100000000000000000000000000000000000000000000001
100000000000000000000000000000000000000000000001
111111111111111111111111111111111111111111111111

