NO textures/bluestone.xpm
SO textures/colorstone.xpm
WE ./textures/greystone.xpm
EA textures/eagle.xpm

F  112,112,112
C  56,56,56

111111111111111111111111
100000000000000000000001
100000000000000000000001
100000000000000000000001
100000111110000101010001
100000100010000000000001
100000100010000100010001
100000100010000000000001
100000113110000101010001
100000000000000000000001
100000000000000000000001
100000000000000000000001
1000000000E0000020000001
100000000000000000000001
100000000000000000000001
100000000000000000000001
111111111000000000000001
110000101000000002000001
110100101000000000000001
110100001000000000000001
113111111000000000000001
110000000000000000000001
111111111000000000000001
111111111111111111111111
